300
50
25
32
9
4
2
1
2
1
3
0
0
0
100
85
6
63 106
4 2
24 37 43 58 61 65 69 101 112
1 1 1 1 1 1 1 2 2
118
1
16 40 81 89
1 4 1 1
104 108
3 3
0 4 4 4 2 1 1 1 1 1 2 4 1 1 4 4 4 4 4 4 2 1 3 4 3 1 2 6 4 2 1 1
0 6 2 3 2 4 4 2 2 4 2 2 1 1 2 2 2 2 2 2 2 1 2 2 2 1 2 10 10 8 131 131
0 12 21 28 33 33 39 40 40 45 47 51 53 72 73 77 81 85 89 93 99 101 102 106 110 112 113 -4 118 120 -4 -4
0 3 1 3 1 3 3 2 6 3 1 3 6 6 3 1 3 1 3 1 1 1 1 3 1 1 1 1 3 1 0 7

0
0
118
120
3
1
