300
50
25
78
6
8
1
2
7
14
3
0
0
0
100
-35 87
6 6
-31 49 -19 27 27 27 86
6 6 -12 -15 -18 -20 -23
0 -4 81 82 87 79
-6 -6 1 1 1 -26
-15 -13 -11 -9 -7 -5 -17 57 57 57 60 55 73 15
1 2 4 3 1 5 -6 -10 -12 -14 -20 -23 -27 1
-1 -6 -12 15 23 37 31 67
3 -4 -4 5 3 3 -27 -27
-27
0
1 1 1 1 1 1 1 1 1 1 1 1 1 1 1 1 1 1 13 1 1 1 1 1 1 2 1 1 1 2 2 1 2 2 1 1 1 6 1 6 1 1 1 1 1 20 25 1 6 1 1 24 24 1 1 1 1 1 1 1 1 1 1 1 1 1 1 1 1 1 1 1 1 6 1 1 1 1
2 1 2 3 2 2 3 74 6 5 4 3 2 5 4 3 2 134 2 33 3 2 4 3 2 2 6 5 4 2 2 32 2 2 4 3 2 2 24 2 6 4 3 2 68 3 18 2 2 39 17 2 2 4 3 2 7 5 5 7 4 2 16 15 2 2 2 2 2 2 2 2 39 2 3 2 2 3
13 14 15 23 23 23 23 -25 -33 -33 -33 -33 -33 -24 -23 -22 -21 -43 -43 -43 -41 -37 -33 -33 -33 -33 -23 -22 -21 -12 -12 -6 -6 -6 1 1 1 -21 -21 1 20 21 22 23 23 23 31 79 89 52 52 52 67 1 1 1 32 33 33 32 44 45 53 54 69 71 73 76 79 80 84 85 52 89 0 1 1 0
1 2 3 1 2 5 6 0 0 1 2 3 4 1 2 3 4 7 -6 -7 0 -3 -6 -5 -4 5 -6 -5 -4 -6 -2 -7 -6 -2 -6 -5 -4 -13 -14 -13 -1 -2 -3 -4 -28 -27 -25 -27 -27 -21 -25 -24 -24 -6 -5 -4 1 2 5 6 1 2 1 2 5 3 5 2 1 4 2 3 0 1 1 2 5 6
0 0 0 0 0 0 0 3 3 3 0 3 0 0
3 3 3 3 3 3 3 0 0 0 3 0 3 0
-15 -13 -11 -9 -7 -5 -17 57 57 57 60 55 73 15
-13 -11 -9 -7 -5 -3 -15 63 63 63 62 67 75 17
7 7 7 7 7 7 0 -12 -10 -8 -17 -22 -21 0
1 1 1 1 1 1 -6 -10 -12 -14 -20 -23 -27 1
18
-25 -24 -23 -22 -1 0 12 13 14 31 32 43 44 52 53 -24 -23 -22
1 2 3 4 1 2 1 2 3 1 2 1 2 1 2 -6 -5 -4
16
-28 -29 -30 -31 25 26 38 39 47 48 -29 -30 -31 5 4 3
1 2 3 4 2 1 2 1 2 1 -6 -5 -4 -6 -5 -4
7
12 -25 -24 31 43 52 -1
15 -21 -21 33 45 54 1
1 1 -6 1 1 1 1
4 5 -3 3 3 3 3
6
-31 -31 3 25 38 47
-27 -28 6 27 40 49
5 -3 -3 3 3 3
1 -6 -6 1 1 1




4
-31 -3 -31 -6 -21 -6 -21 -3
31 -22 31 -27 48 -27 48 -22
48 2 48 -27 53 -27 53 2
53 -25 53 -27 67 -27 67 -25
18 15 19 0
0 1 2 13 14 15 16 60 61 56 57 26 27 28 63 62 74 75
56 57 60 61 4 3 9 10 11 22 23 24 34 35 36
0 1 11 10 9 60 56 13 14 15 26 27 62 74 3 22 23 34 35

1
1
16
-19
-11

1
87
-27
0


2
-19 -18
-10 -10

6
-41 -39 -37 9 15 27
6 6 -4 -1 -1 -1
